8, 8
266, 259, 259, 259, 259, 259, 259, 264
265, 259, 259, 259, 259, 259, 259, 259
259, 259, 259, 259, 259, 259, 259, 259
259, 292, 292, 259, 259, 292, 292, 259
259, 291, 259, 259, 259, 259, 291, 259
259, 290, 259, 259, 259, 259, 290, 259
285, 287, 285, 284, 285, 284, 289, 284
284, 286, 284, 285, 284, 285, 288, 285
