10, 8
579, 579, 596, 578, 578, 596, 575, 575, 575, 575
599, 600, 596, 596, 596, 596, 591, 588, 588, 588
597, 598, 596, 596, 596, 579, 589, 575, 575, 575
579, 579, 596, 596, 596, 579, 589, 575, 575, 575
599, 600, 596, 596, 596, 579, 589, 575, 575, 575
597, 598, 596, 596, 596, 579, 589, 575, 575, 575
579, 579, 596, 596, 596, 579, 589, 575, 575, 575
567, 567, 567, 567, 567, 567, 593, 567, 567, 567
