10, 8
259, 259, 259, 282, 262, 263, 282, 259, 259, 259
259, 259, 259, 281, 262, 263, 281, 259, 259, 259
259, 259, 259, 259, 262, 263, 259, 259, 259, 259
259, 259, 259, 259, 262, 263, 259, 259, 259, 259
259, 259, 259, 259, 262, 263, 259, 259, 259, 259
259, 259, 259, 259, 262, 263, 259, 259, 259, 259
259, 259, 259, 282, 262, 263, 282, 259, 259, 259
261, 261, 261, 283, 280, 280, 283, 261, 261, 261
