8, 8
917, 917, 932, 932, 917, 917, 917, 954
917, 917, 917, 917, 917, 917, 917, 917
917, 917, 917, 917, 917, 917, 917, 917
917, 917, 917, 917, 917, 917, 947, 948
917, 917, 917, 917, 917, 920, 918, 919
917, 917, 917, 917, 917, 917, 917, 917
917, 917, 917, 917, 917, 917, 917, 917
916, 916, 921, 916, 916, 916, 916, 916
