8, 8
506, 506, 520, 520, 506, 506, 506, 506
506, 506, 506, 506, 506, 506, 506, 506
506, 506, 506, 506, 506, 506, 506, 506
506, 506, 506, 506, 506, 506, 506, 506
508, 508, 506, 506, 506, 506, 508, 508
507, 507, 506, 506, 506, 506, 507, 507
536, 537, 508, 529, 531, 508, 536, 537
530, 535, 527, 528, 530, 527, 530, 535
