30, 8
910, 910, 910, 910, 910, 910, 910, 910, 910, 910, 910, 910, 910, 910, 910, 910, 910, 910, 910, 910, 910, 910, 910, 910, 910, 910, 910, 910, 910, 910
910, 910, 908, 908, 908, 908, 908, 908, 908, 908, 908, 908, 908, 908, 908, 908, 908, 908, 908, 908, 908, 908, 908, 908, 908, 908, 908, 908, 910, 910
910, 912, 913, 913, 913, 913, 913, 913, 913, 913, 913, 913, 913, 913, 913, 913, 913, 913, 913, 913, 913, 913, 913, 913, 913, 913, 913, 931, 909, 910
910, 912, 913, 913, 913, 913, 913, 913, 913, 913, 913, 913, 913, 913, 913, 913, 913, 913, 913, 913, 913, 913, 913, 913, 913, 913, 913, 913, 909, 910
910, 912, 915, 916, 915, 916, 915, 921, 915, 916, 915, 921, 915, 916, 915, 921, 915, 916, 915, 921, 915, 916, 915, 921, 915, 916, 915, 916, 909, 910
910, 910, 914, 914, 914, 914, 914, 914, 914, 914, 914, 914, 914, 914, 914, 914, 914, 914, 914, 914, 914, 914, 914, 914, 914, 914, 914, 914, 910, 910
910, 910, 910, 910, 910, 910, 910, 910, 910, 910, 910, 910, 910, 910, 910, 910, 910, 910, 910, 910, 910, 910, 910, 910, 910, 910, 910, 910, 910, 910
910, 910, 910, 910, 910, 910, 910, 910, 910, 910, 910, 910, 910, 910, 910, 910, 910, 910, 910, 910, 910, 910, 910, 910, 910, 910, 910, 910, 910, 910
