10, 12
40, 40, 40, 40, 36, 36, 40, 40, 40, 40
40, 36, 40, 40, 36, 36, 36, 40, 36, 40
40, 40, 36, 59, 36, 36, 40, 36, 40, 40
40, 40, 36, 58, 36, 36, 36, 40, 40, 40
40, 36, 40, 40, 36, 36, 40, 36, 40, 36
36, 40, 40, 36, 36, 36, 36, 40, 36, 40
40, 40, 36, 36, 36, 36, 40, 36, 40, 40
40, 40, 36, 40, 36, 36, 36, 40, 40, 40
40, 40, 36, 36, 36, 36, 36, 36, 40, 36
40, 36, 36, 36, 36, 36, 36, 40, 36, 40
36, 36, 36, 36, 36, 36, 36, 36, 36, 36
60, 60, 60, 60, 36, 36, 60, 60, 60, 60
