8, 8
259, 259, 269, 269, 259, 267, 259, 260
259, 259, 259, 259, 259, 267, 259, 260
259, 259, 259, 259, 259, 267, 259, 259
292, 259, 259, 292, 259, 273, 278, 278
259, 259, 259, 259, 259, 259, 259, 259
292, 259, 259, 292, 259, 259, 259, 259
259, 259, 259, 266, 276, 276, 276, 276
261, 261, 261, 265, 275, 275, 275, 275
