8, 12
621, 621, 621, 621, 666, 666, 621, 621
621, 621, 621, 621, 621, 621, 621, 621
625, 625, 625, 625, 634, 635, 621, 621
624, 624, 624, 624, 621, 621, 621, 621
639, 640, 624, 624, 621, 628, 621, 621
637, 638, 624, 624, 627, 623, 621, 621
624, 624, 624, 624, 624, 623, 621, 621
624, 624, 624, 624, 624, 623, 621, 621
624, 642, 659, 642, 624, 623, 621, 621
625, 655, 658, 655, 625, 626, 621, 621
636, 636, 620, 621, 621, 623, 621, 620
636, 636, 619, 619, 622, 623, 619, 619
