8, 12
621, 621, 621, 621, 621, 621, 621, 621
621, 621, 621, 621, 621, 621, 621, 621
625, 625, 625, 625, 634, 635, 621, 621
661, 624, 624, 624, 621, 621, 621, 621
660, 624, 624, 644, 644, 628, 621, 621
632, 633, 624, 643, 643, 623, 621, 621
630, 631, 624, 624, 624, 623, 621, 621
624, 624, 624, 624, 624, 623, 621, 621
642, 642, 642, 642, 642, 623, 621, 621
641, 641, 641, 641, 641, 626, 621, 621
636, 636, 645, 621, 620, 623, 620, 645
636, 636, 619, 619, 619, 623, 619, 619
