14, 8
862, 862, 843, 858, 858, 843, 862, 862, 843, 843, 843, 843, 862, 862
861, 861, 843, 843, 843, 843, 861, 861, 843, 843, 843, 843, 861, 861
854, 855, 843, 843, 843, 843, 843, 843, 843, 843, 843, 843, 843, 843
852, 853, 843, 843, 843, 843, 843, 843, 843, 843, 843, 843, 843, 876
843, 843, 843, 843, 843, 843, 843, 843, 843, 843, 843, 843, 843, 877
850, 851, 848, 849, 848, 850, 848, 848, 848, 848, 880, 843, 880, 848
842, 846, 864, 855, 843, 842, 846, 847, 843, 843, 843, 843, 843, 843
842, 844, 845, 863, 841, 842, 844, 845, 859, 859, 860, 859, 860, 859
