8, 6
260, 260, 259, 262, 263, 259, 260, 260
260, 259, 277, 259, 259, 277, 259, 260
260, 259, 267, 259, 259, 267, 259, 260
260, 259, 267, 259, 259, 267, 259, 260
260, 276, 274, 259, 259, 274, 276, 260
260, 275, 259, 262, 263, 259, 275, 260
