8, 8
385, 388, 357, 351, 351, 357, 387, 386
389, 351, 355, 351, 351, 355, 351, 389
390, 351, 351, 351, 351, 351, 351, 390
389, 351, 351, 351, 351, 351, 351, 389
390, 351, 351, 351, 351, 351, 351, 390
389, 351, 351, 351, 351, 351, 351, 389
390, 351, 357, 351, 351, 357, 351, 390
389, 350, 355, 351, 351, 355, 350, 389
