10, 8
518, 506, 506, 506, 520, 520, 506, 506, 506, 518
517, 506, 506, 506, 506, 506, 506, 506, 506, 517
506, 506, 506, 506, 506, 506, 506, 506, 506, 506
506, 506, 506, 506, 506, 506, 506, 506, 506, 506
515, 516, 506, 506, 549, 550, 506, 545, 506, 545
554, 555, 506, 506, 547, 548, 506, 545, 545, 545
506, 506, 506, 506, 506, 506, 506, 506, 506, 506
505, 505, 505, 505, 505, 505, 505, 505, 505, 505
