8, 8
644, 644, 666, 666, 624, 624, 644, 644
643, 643, 624, 624, 624, 624, 643, 643
624, 624, 624, 624, 624, 624, 624, 624
624, 624, 639, 668, 668, 640, 624, 624
624, 624, 637, 652, 652, 638, 624, 624
624, 624, 624, 624, 624, 624, 624, 624
624, 624, 642, 659, 659, 642, 624, 624
619, 619, 665, 658, 658, 665, 619, 619
