10, 8
260, 260, 260, 259, 262, 263, 259, 260, 260, 260
260, 259, 267, 259, 259, 259, 259, 260, 279, 260
260, 259, 267, 259, 259, 259, 259, 259, 259, 260
260, 259, 267, 259, 259, 259, 259, 270, 260, 260
260, 259, 267, 259, 259, 259, 259, 267, 259, 260
260, 259, 267, 259, 259, 259, 259, 267, 259, 260
260, 276, 267, 259, 259, 259, 259, 267, 276, 260
260, 275, 260, 259, 262, 263, 259, 260, 275, 260
