8, 8
416, 407, 420, 420, 435, 436, 445, 446
415, 407, 407, 407, 433, 434, 407, 407
407, 407, 433, 434, 407, 407, 407, 407
407, 407, 439, 444, 422, 408, 407, 407
407, 407, 408, 409, 410, 439, 435, 436
440, 441, 437, 438, 407, 407, 433, 434
418, 418, 443, 437, 407, 407, 407, 407
417, 417, 431, 442, 414, 411, 431, 431
