8, 8
448, 448, 465, 465, 448, 448, 448, 448
448, 448, 448, 448, 448, 448, 448, 448
448, 450, 452, 448, 448, 448, 448, 448
448, 449, 451, 448, 448, 448, 448, 448
448, 448, 448, 448, 448, 448, 448, 448
461, 462, 463, 464, 464, 461, 462, 463
455, 456, 459, 460, 460, 455, 456, 459
453, 454, 457, 458, 458, 453, 454, 457
