20, 6
910, 910, 910, 910, 910, 910, 910, 910, 910, 910, 910, 910, 910, 910, 910, 910, 910, 910, 910, 910
908, 908, 908, 908, 908, 908, 908, 908, 908, 908, 908, 908, 908, 908, 908, 908, 908, 908, 908, 908
913, 913, 913, 913, 913, 913, 913, 913, 913, 913, 913, 913, 913, 913, 913, 913, 913, 913, 913, 930
916, 926, 913, 913, 913, 913, 913, 913, 913, 913, 913, 913, 913, 913, 913, 913, 913, 913, 923, 926
910, 912, 915, 916, 915, 916, 915, 916, 915, 916, 915, 916, 915, 916, 915, 916, 915, 916, 909, 910
910, 910, 914, 914, 914, 914, 914, 914, 914, 914, 914, 914, 914, 914, 914, 914, 914, 914, 910, 910
