20, 8
575, 575, 575, 575, 575, 575, 575, 575, 575, 589, 575, 575, 582, 583, 582, 583, 582, 583, 575, 575
588, 588, 588, 588, 588, 588, 588, 588, 588, 604, 575, 575, 580, 581, 580, 581, 580, 581, 575, 575
575, 575, 575, 575, 575, 575, 575, 575, 575, 575, 575, 575, 575, 575, 575, 575, 575, 575, 575, 575
575, 575, 582, 583, 582, 583, 582, 583, 582, 583, 575, 575, 582, 583, 582, 583, 582, 583, 575, 575
575, 575, 580, 581, 580, 581, 580, 581, 580, 581, 575, 575, 580, 581, 580, 581, 580, 581, 575, 575
575, 575, 575, 575, 575, 575, 575, 575, 575, 575, 575, 575, 575, 575, 575, 575, 575, 575, 575, 575
567, 584, 585, 567, 567, 567, 567, 567, 567, 567, 567, 567, 569, 567, 602, 567, 568, 567, 567, 567
566, 566, 566, 566, 566, 566, 566, 566, 566, 566, 566, 566, 566, 566, 566, 566, 566, 566, 566, 566
