10, 8
266, 259, 259, 259, 269, 269, 259, 259, 259, 266
265, 259, 259, 259, 259, 259, 277, 259, 277, 265
266, 259, 259, 259, 259, 259, 274, 259, 274, 266
265, 259, 259, 259, 259, 259, 259, 259, 259, 265
266, 259, 259, 259, 259, 259, 277, 259, 277, 266
265, 259, 259, 259, 259, 259, 274, 259, 274, 265
259, 259, 259, 259, 259, 259, 259, 259, 259, 259
293, 293, 293, 293, 293, 280, 293, 293, 293, 293
