20, 8
607, 608, 595, 595, 595, 595, 595, 595, 595, 595, 595, 595, 595, 595, 595, 595, 595, 595, 615, 607
607, 608, 596, 596, 596, 596, 596, 596, 596, 596, 596, 596, 596, 596, 596, 596, 596, 596, 615, 607
607, 608, 596, 596, 596, 596, 596, 579, 599, 600, 579, 596, 596, 596, 596, 596, 596, 596, 615, 607
607, 608, 596, 596, 596, 596, 596, 579, 597, 598, 579, 596, 596, 596, 596, 596, 596, 596, 615, 607
607, 608, 596, 579, 599, 600, 579, 596, 596, 596, 596, 596, 596, 596, 596, 596, 596, 596, 615, 607
607, 608, 596, 579, 597, 598, 579, 596, 596, 596, 596, 596, 590, 602, 567, 569, 567, 567, 615, 607
607, 608, 596, 596, 596, 596, 596, 596, 596, 596, 590, 590, 594, 613, 613, 613, 613, 613, 615, 607
607, 608, 595, 595, 595, 595, 595, 595, 595, 595, 594, 594, 604, 612, 612, 612, 612, 612, 615, 607
