8, 8
899, 888, 888, 888, 888, 888, 905, 888
898, 888, 888, 888, 888, 888, 904, 888
888, 888, 888, 892, 888, 888, 888, 888
888, 888, 888, 895, 888, 888, 888, 888
888, 888, 888, 888, 888, 888, 888, 888
888, 888, 888, 888, 888, 888, 888, 888
902, 884, 886, 888, 888, 888, 888, 894
900, 901, 903, 887, 887, 891, 887, 891
