8, 12
621, 621, 621, 621, 621, 621, 621, 621
621, 621, 621, 621, 621, 621, 621, 621
625, 625, 625, 625, 634, 635, 621, 621
624, 624, 624, 624, 621, 621, 621, 621
632, 633, 624, 624, 621, 628, 621, 621
630, 631, 624, 624, 627, 623, 621, 621
624, 624, 624, 624, 624, 623, 621, 621
632, 633, 624, 632, 633, 623, 621, 621
630, 631, 624, 630, 631, 623, 621, 621
625, 625, 625, 625, 625, 626, 621, 621
636, 636, 620, 621, 645, 623, 645, 620
636, 636, 619, 619, 619, 623, 619, 619
