8, 8
855, 843, 843, 858, 858, 843, 843, 843
872, 873, 855, 843, 843, 843, 843, 843
855, 875, 855, 843, 843, 843, 843, 843
859, 874, 855, 843, 870, 871, 870, 871
868, 869, 843, 843, 868, 869, 868, 869
855, 843, 843, 843, 843, 843, 843, 843
857, 857, 867, 867, 867, 867, 857, 857
856, 856, 866, 866, 866, 866, 856, 856
