8, 12
628, 650, 649, 649, 649, 649, 648, 628
623, 621, 621, 621, 621, 621, 621, 623
623, 650, 649, 649, 648, 628, 621, 623
623, 621, 621, 621, 621, 623, 621, 623
623, 656, 622, 657, 621, 623, 621, 623
623, 651, 653, 654, 621, 623, 621, 623
623, 651, 653, 654, 621, 623, 621, 623
623, 637, 652, 638, 621, 623, 621, 623
623, 621, 621, 621, 621, 623, 621, 623
623, 621, 621, 621, 621, 623, 621, 623
623, 621, 645, 621, 621, 623, 645, 623
667, 625, 625, 625, 625, 647, 625, 646
