18, 8
506, 506, 520, 520, 506, 506, 506, 506, 506, 506, 506, 506, 506, 506, 506, 506, 506, 506
506, 506, 506, 506, 506, 506, 506, 506, 506, 506, 506, 506, 506, 506, 506, 506, 506, 506
506, 506, 506, 506, 506, 506, 506, 506, 506, 506, 506, 506, 506, 506, 506, 506, 506, 506
506, 506, 506, 506, 506, 506, 541, 505, 539, 540, 505, 505, 539, 540, 505, 505, 539, 540
518, 506, 506, 506, 506, 518, 538, 538, 538, 538, 538, 538, 538, 538, 538, 538, 538, 538
517, 505, 505, 509, 505, 517, 538, 538, 538, 538, 538, 538, 538, 538, 538, 538, 538, 538
538, 538, 538, 538, 538, 538, 538, 538, 538, 538, 538, 538, 538, 538, 538, 538, 538, 538
538, 538, 538, 538, 538, 538, 538, 538, 538, 538, 538, 538, 538, 538, 538, 538, 538, 538
