40, 18
910, 910, 928, 908, 910, 910, 910, 910, 910, 910, 910, 910, 910, 910, 910, 910, 910, 910, 910, 910, 910, 910, 910, 910, 910, 910, 910, 910, 910, 910, 910, 910, 910, 910, 910, 910, 910, 910, 910, 910
910, 910, 911, 927, 909, 910, 910, 910, 910, 910, 910, 910, 910, 910, 910, 910, 910, 910, 910, 910, 910, 910, 910, 910, 910, 910, 910, 910, 910, 910, 910, 910, 910, 910, 910, 910, 908, 908, 910, 910
910, 912, 924, 913, 909, 910, 910, 910, 910, 910, 910, 910, 910, 910, 910, 910, 910, 910, 910, 910, 910, 910, 910, 910, 910, 910, 910, 910, 910, 910, 910, 910, 910, 910, 910, 912, 913, 930, 909, 910
910, 912, 924, 913, 909, 910, 910, 910, 910, 910, 910, 910, 910, 910, 910, 910, 910, 910, 910, 910, 910, 910, 910, 910, 910, 910, 910, 910, 910, 910, 910, 910, 910, 910, 910, 912, 913, 913, 909, 910
910, 912, 924, 913, 909, 910, 910, 910, 910, 910, 910, 910, 910, 910, 910, 910, 910, 910, 910, 910, 910, 910, 910, 910, 910, 910, 910, 910, 910, 910, 910, 910, 910, 910, 910, 912, 924, 913, 909, 910
910, 912, 924, 913, 909, 910, 910, 910, 910, 910, 910, 910, 910, 910, 910, 910, 910, 910, 910, 910, 910, 910, 910, 910, 910, 910, 910, 910, 910, 910, 910, 910, 910, 910, 910, 912, 924, 913, 909, 910
910, 912, 924, 913, 909, 910, 910, 910, 910, 910, 910, 910, 910, 910, 910, 910, 910, 910, 910, 910, 910, 910, 910, 910, 910, 910, 910, 910, 910, 910, 910, 910, 910, 910, 910, 912, 924, 913, 909, 910
910, 912, 924, 913, 909, 910, 910, 910, 910, 910, 910, 910, 910, 910, 910, 910, 910, 910, 910, 910, 910, 910, 910, 910, 910, 910, 910, 910, 910, 910, 910, 910, 910, 910, 910, 912, 924, 913, 909, 910
910, 912, 924, 913, 909, 910, 928, 908, 929, 910, 928, 908, 929, 910, 928, 908, 929, 910, 928, 908, 929, 910, 928, 908, 929, 910, 910, 910, 910, 910, 928, 908, 929, 910, 910, 912, 924, 913, 909, 910
910, 912, 924, 913, 907, 908, 911, 927, 907, 908, 911, 927, 907, 908, 911, 927, 907, 908, 911, 927, 907, 908, 911, 927, 907, 908, 908, 908, 908, 908, 911, 927, 907, 908, 908, 911, 913, 913, 909, 910
910, 912, 924, 913, 913, 913, 913, 913, 913, 913, 913, 913, 913, 913, 913, 913, 913, 913, 913, 913, 913, 913, 913, 913, 913, 913, 913, 913, 913, 913, 913, 913, 913, 913, 913, 913, 913, 913, 909, 910
910, 912, 931, 913, 913, 913, 913, 913, 913, 913, 913, 913, 913, 913, 913, 913, 913, 913, 913, 913, 913, 913, 913, 913, 913, 913, 913, 913, 913, 913, 913, 913, 913, 913, 913, 913, 913, 913, 909, 910
910, 912, 915, 916, 915, 916, 915, 916, 915, 916, 915, 916, 915, 916, 915, 916, 915, 916, 915, 916, 915, 916, 915, 916, 916, 926, 924, 913, 923, 916, 915, 916, 915, 916, 915, 916, 915, 916, 909, 910
910, 910, 914, 914, 914, 914, 914, 914, 914, 914, 914, 914, 914, 914, 914, 914, 914, 914, 914, 914, 914, 914, 914, 914, 914, 925, 924, 913, 922, 914, 914, 914, 914, 914, 914, 914, 914, 914, 910, 910
910, 910, 910, 910, 910, 910, 910, 910, 910, 910, 910, 910, 910, 910, 910, 910, 910, 910, 910, 910, 910, 910, 910, 910, 910, 912, 924, 913, 909, 910, 910, 910, 910, 910, 910, 910, 910, 910, 910, 910
910, 910, 910, 910, 910, 910, 910, 910, 910, 910, 910, 910, 910, 910, 910, 910, 910, 910, 910, 910, 910, 910, 910, 910, 910, 912, 924, 913, 909, 910, 910, 910, 910, 910, 910, 910, 910, 910, 910, 910
910, 910, 910, 910, 910, 910, 910, 910, 910, 910, 910, 910, 910, 910, 910, 910, 910, 910, 910, 910, 910, 910, 910, 910, 910, 912, 924, 913, 909, 910, 910, 910, 910, 910, 910, 910, 910, 910, 910, 910
910, 910, 910, 910, 910, 910, 910, 910, 910, 910, 910, 910, 910, 910, 910, 910, 910, 910, 910, 910, 910, 910, 910, 910, 910, 912, 924, 913, 909, 910, 910, 910, 910, 910, 910, 910, 910, 910, 910, 910
