8, 8
518, 506, 520, 520, 506, 506, 506, 518
517, 506, 506, 506, 506, 506, 506, 517
506, 506, 506, 525, 506, 525, 506, 506
506, 506, 506, 532, 533, 534, 506, 506
506, 506, 506, 521, 526, 522, 506, 506
506, 506, 506, 525, 506, 525, 506, 506
518, 506, 506, 506, 506, 506, 506, 518
517, 505, 505, 509, 505, 505, 505, 517
