8, 8
506, 506, 520, 520, 506, 506, 506, 506
506, 506, 506, 506, 506, 506, 506, 506
515, 516, 515, 516, 506, 506, 523, 524
513, 514, 513, 514, 506, 506, 521, 522
519, 519, 519, 519, 506, 506, 506, 506
519, 519, 519, 519, 506, 506, 506, 506
508, 529, 531, 508, 536, 537, 508, 508
527, 528, 530, 527, 530, 535, 507, 507
