10, 8
64, 64, 64, 64, 64, 64, 64, 64, 64, 64
64, 64, 64, 96, 106, 106, 103, 64, 64, 64
64, 64, 96, 97, 100, 100, 102, 103, 64, 64
64, 115, 116, 95, 107, 108, 95, 117, 118, 64
64, 64, 84, 85, 100, 100, 90, 91, 64, 64
64, 64, 64, 84, 86, 86, 89, 64, 64, 64
105, 64, 64, 64, 64, 64, 64, 64, 64, 105
104, 69, 113, 114, 92, 93, 113, 114, 69, 104
