10, 8
358, 358, 358, 358, 354, 354, 358, 358, 358, 358
358, 358, 358, 358, 358, 358, 358, 358, 358, 358
358, 358, 358, 358, 358, 358, 358, 358, 358, 358
358, 358, 358, 358, 358, 358, 358, 358, 358, 358
358, 358, 358, 358, 358, 358, 358, 358, 358, 358
358, 358, 358, 358, 379, 380, 358, 358, 358, 358
358, 358, 358, 358, 396, 397, 358, 358, 358, 358
350, 350, 350, 350, 350, 350, 350, 350, 350, 350
