14, 8
518, 506, 506, 506, 520, 520, 506, 506, 506, 506, 506, 506, 506, 518
517, 506, 506, 506, 506, 506, 506, 506, 506, 506, 506, 506, 506, 517
552, 553, 506, 506, 551, 552, 552, 552, 552, 552, 552, 552, 552, 552
506, 506, 506, 506, 506, 506, 506, 506, 506, 506, 506, 506, 506, 506
506, 506, 506, 506, 506, 532, 533, 534, 506, 506, 523, 524, 506, 506
506, 506, 506, 506, 506, 521, 526, 522, 506, 506, 521, 522, 506, 506
512, 512, 512, 512, 506, 506, 506, 506, 506, 506, 525, 506, 506, 506
511, 511, 511, 511, 505, 505, 505, 509, 505, 505, 505, 505, 505, 505
