14, 8
259, 259, 259, 259, 259, 259, 259, 264, 267, 259, 259, 259, 259, 259
259, 259, 259, 259, 259, 259, 259, 259, 267, 259, 259, 259, 259, 259
259, 300, 303, 304, 310, 259, 259, 259, 274, 259, 259, 259, 259, 259
259, 311, 312, 313, 314, 259, 259, 259, 259, 259, 259, 259, 259, 259
259, 259, 259, 259, 259, 259, 259, 259, 259, 259, 259, 259, 259, 259
259, 259, 259, 259, 259, 259, 259, 259, 259, 259, 297, 298, 306, 259
259, 259, 259, 259, 259, 259, 259, 259, 259, 259, 294, 295, 296, 259
293, 293, 293, 293, 293, 293, 293, 293, 293, 293, 293, 293, 293, 293
