8, 8
7, 7, 21, 21, 7, 7, 7, 7
7, 1, 1, 1, 1, 1, 7, 7
7, 1, 1, 1, 1, 1, 7, 7
7, 1, 1, 1, 20, 1, 7, 7
7, 1, 1, 1, 1, 1, 7, 7
7, 1, 1, 1, 1, 1, 7, 7
7, 7, 7, 7, 7, 7, 7, 7
7, 7, 7, 7, 7, 7, 7, 7
