8, 8
64, 64, 65, 65, 64, 64, 64, 80
64, 64, 64, 64, 64, 64, 80, 64
75, 76, 64, 64, 64, 64, 64, 64
75, 76, 64, 64, 64, 64, 64, 64
64, 64, 64, 64, 64, 77, 78, 79
75, 76, 75, 76, 64, 68, 64, 64
72, 73, 75, 76, 64, 68, 64, 64
70, 71, 69, 74, 66, 67, 69, 69
