20, 8
259, 259, 259, 259, 259, 259, 259, 279, 267, 259, 269, 269, 259, 266, 267, 259, 269, 269, 259, 266
259, 300, 303, 304, 310, 259, 259, 259, 267, 259, 259, 259, 259, 265, 267, 259, 259, 259, 259, 265
259, 299, 301, 302, 309, 259, 259, 259, 274, 259, 259, 277, 278, 271, 274, 259, 259, 259, 259, 259
259, 259, 259, 259, 259, 259, 259, 259, 259, 259, 259, 267, 259, 259, 259, 259, 259, 259, 259, 259
259, 300, 303, 304, 310, 259, 259, 259, 259, 259, 259, 267, 292, 259, 259, 259, 259, 259, 259, 259
259, 299, 301, 302, 309, 259, 259, 259, 259, 259, 259, 267, 292, 259, 259, 259, 307, 259, 259, 259
259, 259, 259, 259, 259, 259, 259, 259, 259, 259, 259, 267, 276, 276, 276, 276, 276, 276, 276, 276
293, 293, 293, 293, 293, 293, 293, 308, 293, 308, 293, 305, 275, 275, 275, 275, 275, 275, 275, 275
