10, 8
590, 590, 590, 590, 578, 578, 590, 590, 590, 590
594, 594, 594, 594, 596, 596, 594, 594, 594, 594
596, 596, 596, 596, 596, 596, 596, 596, 596, 596
596, 596, 596, 596, 596, 596, 596, 596, 596, 596
596, 596, 596, 596, 596, 596, 596, 596, 596, 596
588, 588, 588, 588, 588, 588, 588, 588, 588, 588
613, 613, 614, 613, 614, 613, 614, 613, 613, 613
612, 612, 612, 612, 612, 612, 612, 612, 612, 612
