20, 8
575, 575, 572, 573, 573, 573, 576, 575, 575, 575, 575, 575, 589, 575, 575, 575, 582, 583, 582, 583
575, 575, 570, 571, 574, 570, 571, 575, 575, 575, 575, 575, 589, 575, 575, 575, 580, 581, 580, 581
575, 575, 572, 573, 573, 573, 576, 575, 575, 575, 575, 575, 589, 575, 575, 575, 575, 575, 575, 575
575, 575, 570, 571, 574, 570, 571, 575, 575, 575, 575, 575, 587, 588, 588, 588, 588, 588, 588, 588
575, 575, 575, 575, 575, 575, 575, 575, 575, 575, 575, 575, 575, 575, 575, 575, 575, 575, 575, 575
575, 575, 575, 575, 575, 575, 575, 575, 575, 575, 575, 575, 575, 575, 575, 575, 575, 575, 590, 590
567, 584, 585, 567, 601, 567, 601, 567, 601, 567, 601, 567, 568, 567, 602, 567, 569, 567, 571, 571
566, 566, 566, 566, 566, 566, 566, 566, 566, 566, 566, 566, 566, 566, 566, 566, 566, 566, 566, 566
