10, 12
356, 356, 351, 351, 351, 351, 351, 351, 356, 356
351, 356, 351, 357, 351, 351, 356, 356, 351, 356
356, 351, 356, 355, 351, 351, 356, 356, 356, 351
356, 356, 351, 351, 351, 351, 356, 351, 356, 356
356, 356, 351, 351, 351, 351, 356, 356, 356, 356
356, 351, 356, 356, 351, 351, 351, 351, 356, 351
356, 356, 356, 351, 351, 351, 351, 356, 356, 356
356, 351, 351, 351, 351, 351, 351, 351, 351, 356
356, 351, 351, 351, 351, 351, 351, 351, 351, 351
356, 356, 351, 351, 351, 351, 351, 351, 356, 356
351, 351, 351, 351, 351, 351, 351, 351, 351, 351
350, 350, 350, 350, 351, 351, 350, 350, 350, 350
