8, 8
416, 407, 420, 420, 407, 407, 407, 416
415, 407, 407, 407, 407, 407, 407, 415
407, 407, 407, 407, 407, 407, 407, 407
407, 407, 408, 421, 422, 408, 407, 407
407, 407, 408, 409, 410, 408, 407, 407
407, 407, 407, 407, 407, 407, 407, 407
413, 413, 407, 407, 407, 407, 407, 418
412, 412, 411, 423, 411, 414, 411, 417
