8, 8
266, 259, 259, 269, 269, 259, 259, 266
265, 270, 271, 259, 259, 270, 271, 265
259, 267, 259, 259, 259, 259, 267, 259
259, 267, 259, 259, 264, 259, 267, 259
259, 267, 259, 259, 259, 259, 267, 259
259, 273, 271, 259, 259, 270, 272, 259
266, 259, 259, 259, 259, 259, 259, 266
265, 261, 261, 261, 261, 261, 261, 265
