8, 8
448, 448, 465, 465, 448, 448, 448, 448
448, 448, 448, 448, 448, 448, 448, 448
448, 448, 485, 486, 488, 489, 448, 448
448, 467, 483, 484, 484, 487, 467, 448
448, 467, 470, 471, 474, 475, 467, 448
448, 448, 468, 469, 472, 473, 448, 448
448, 448, 478, 479, 482, 448, 448, 448
481, 490, 476, 477, 480, 481, 490, 481
