14, 8
862, 862, 843, 858, 858, 843, 862, 862, 843, 843, 843, 843, 862, 862
861, 861, 843, 843, 843, 843, 861, 861, 843, 843, 843, 843, 861, 861
854, 855, 843, 843, 843, 843, 843, 843, 843, 843, 843, 843, 843, 843
852, 853, 843, 843, 843, 843, 843, 843, 843, 843, 843, 843, 843, 843
843, 843, 843, 843, 843, 843, 843, 843, 843, 843, 843, 843, 843, 843
848, 848, 848, 848, 848, 848, 848, 848, 848, 848, 848, 848, 848, 848
843, 843, 843, 843, 843, 843, 843, 843, 843, 843, 843, 843, 862, 862
859, 859, 859, 859, 859, 859, 859, 859, 859, 859, 859, 859, 861, 861
