8, 8
888, 888, 897, 897, 888, 888, 888, 888
888, 888, 888, 888, 888, 888, 888, 888
888, 888, 882, 884, 886, 882, 888, 888
888, 888, 882, 883, 885, 882, 888, 888
888, 888, 888, 888, 888, 888, 888, 888
888, 888, 888, 888, 888, 888, 888, 888
890, 890, 888, 895, 888, 888, 888, 893
889, 889, 887, 891, 887, 891, 887, 891
