8, 8
506, 506, 520, 520, 506, 506, 506, 506
506, 506, 506, 506, 506, 506, 506, 506
515, 516, 506, 506, 506, 506, 512, 512
513, 514, 506, 506, 506, 506, 511, 511
506, 506, 506, 506, 506, 506, 506, 506
506, 506, 506, 506, 506, 506, 506, 506
510, 510, 510, 510, 510, 512, 512, 512
505, 505, 505, 505, 505, 511, 511, 511
