10, 18
351, 351, 351, 351, 354, 354, 351, 351, 351, 351
351, 351, 351, 351, 351, 351, 351, 351, 351, 351
351, 351, 351, 351, 351, 351, 351, 351, 351, 351
351, 351, 351, 357, 351, 351, 357, 351, 351, 351
351, 351, 351, 355, 351, 351, 355, 351, 351, 351
351, 351, 351, 351, 351, 351, 351, 351, 351, 351
351, 365, 351, 365, 351, 365, 351, 365, 351, 365
351, 351, 351, 351, 351, 351, 351, 351, 351, 351
351, 365, 351, 365, 351, 365, 351, 365, 351, 365
351, 351, 351, 351, 351, 351, 351, 351, 351, 351
351, 365, 351, 365, 351, 365, 351, 365, 351, 365
351, 351, 351, 351, 351, 351, 351, 351, 351, 351
369, 362, 362, 371, 351, 351, 369, 362, 362, 371
367, 368, 368, 370, 351, 351, 367, 368, 368, 370
372, 373, 351, 351, 351, 351, 351, 351, 372, 373
372, 373, 351, 351, 351, 351, 351, 351, 372, 373
372, 373, 351, 351, 351, 351, 365, 366, 372, 373
372, 373, 362, 363, 362, 363, 362, 364, 372, 373
