8, 8
416, 407, 420, 420, 407, 407, 407, 416
415, 407, 407, 407, 407, 407, 407, 415
407, 407, 407, 408, 407, 407, 407, 407
407, 407, 407, 432, 422, 407, 407, 407
407, 407, 407, 430, 410, 407, 407, 407
407, 407, 407, 407, 407, 407, 407, 407
407, 407, 407, 407, 407, 407, 407, 418
411, 414, 411, 428, 429, 411, 411, 417
