10, 8
64, 64, 64, 64, 64, 64, 64, 64, 64, 64
64, 64, 64, 96, 106, 106, 103, 64, 64, 64
64, 64, 96, 97, 100, 100, 102, 103, 64, 64
64, 64, 94, 95, 98, 99, 95, 101, 64, 64
64, 64, 84, 85, 87, 88, 90, 91, 64, 64
64, 64, 64, 84, 86, 86, 89, 64, 64, 64
105, 64, 64, 105, 64, 64, 105, 64, 64, 105
104, 69, 69, 104, 92, 93, 104, 69, 69, 104
