20, 8
575, 575, 578, 578, 575, 575, 575, 575, 575, 575, 575, 575, 575, 575, 575, 575, 578, 578, 575, 575
575, 575, 575, 575, 575, 575, 575, 575, 575, 575, 575, 575, 575, 575, 575, 575, 575, 575, 575, 575
575, 575, 575, 575, 575, 575, 575, 575, 575, 575, 575, 575, 575, 575, 575, 575, 575, 575, 575, 579
575, 575, 575, 575, 575, 575, 591, 588, 588, 588, 588, 603, 575, 575, 575, 575, 575, 575, 575, 579
575, 575, 575, 575, 575, 575, 589, 575, 575, 575, 575, 589, 575, 575, 575, 575, 575, 575, 575, 579
575, 575, 575, 575, 575, 575, 589, 575, 575, 575, 575, 589, 575, 575, 575, 575, 590, 590, 575, 579
567, 584, 585, 567, 567, 567, 593, 567, 567, 567, 567, 593, 568, 567, 602, 567, 577, 577, 567, 567
566, 566, 566, 566, 566, 566, 566, 566, 566, 566, 566, 566, 566, 566, 566, 566, 566, 566, 566, 566
